000-------
0S0000----
000000000-
-000000000
-----00T00
------000-

